11111111111111111111
1110000001C000000001
111C0010010000001111
111110100100100C0001
1P000C1C0000100000E1
11111111111111111111
