1111111111111111111111111111111111111111
1P00000000000000000000000000000000000001
10000000000C0000000000000000000000000001
10C0000000000000000C000000C0000000000001
100000C000000000000000000000000000000001
10000000000000C00000000000000C0000000001
100000000C000000000C00000000000000000001
10000000000000000000000000000C0000000001
1E0000000000000C000000000000000000C00001
1111111111111111111111111111111111111111
